e1m1
17 17 0 0
Map1
null 0 0 0 0 0 0 0
/---------------\
|               |
|               |
|    __   __    |
|               |
|               |
|               |
|               |
|               |
|  /-\     /-\  |
|  |_|     |M|  |
|       F       |
|               |
|       P       |
|               |
|               |
\_______________/