e1m1
17 17 0
A basic test map used for testing :)
/---------------\
|               |
|               |
|               |
|        |__    |
|               |
|               |
|               |
|               |
|  /-\     /-\  |
|  |_|     |M|  |
|               |
|               |
| F     P     K |
|               |
|               |
\_______________/