e1m1
17 17 0
Map1
null 0 0 0 0 0 0 0
/---------------\
|               |
|       K       |
| F  __   __  F |
|               |
|       F       |
|               |
|               |
|               |
|  /-\     /-\  |
|  |_|     |M|  |
|               |
|               |
|       P       |
|               |
|               |
\_______________/