e1m2
17 17 0
A basic test map used for testing :)
/---------------\
|               |
|               |
|               |
|        |__    |
|               |
|        |      |
|               |
|        2      |
|  /-\     /-\  |
|  |_|     |M|  |
|               |
|               |
| F     P     K |
|               |
|               |
\_______________/