e1m4
17 17 0 0
Map4
null 0 0 0 0 0 0 0
/---------------\
|               |
|               |
|               |
|        4__    |
|               |
|               |
|               |
|               |
|  /-\     /-\  |
|  |_|     |M|  |
|               |
|               |
| F     P     K |
|               |
|               |
\_______________/