testlevel
17 17 0
A basic test map used for testing :)
ThotGeneral 5 5 5 150 10 2 100
/---------------\
|               |
|   _______     |
|   |     |     |
|   |__   |     |
|   ___|  |     |
|   |     |     |
|   |__   |     |
|      |  |     |
|   ___|  |     |
|  |  F   |     |
|  |      |     |
|  |      |     |
|  |  P   |     |
|  |______|     |
|               |
\_______________/