testlevel
17 17 1
Background
ThotGeneral 5 5 5 150 10 2 100
/---------------\
|               |
|   _______     |
|   |     |     |
|   |__   |     |
|   ___|  |     |
|   |F    |     |
|   |__   |     |
|      |  |     |
|   ___|  |     |
|  |      |     |
|  |      |     |
|  |      |     |
|  |  P X |     |
|  |______|     |
|               |
\_______________/