testlevel
17 17 1
Background
ThotGeneral 5 5 5 150 10 2 100
/_______________\
|               |
|   |_____|     |
|   | G  K|     |
|   |__|  |     |
|   |__|  |     |
|   |F    |     |
|   |__   |     |
|      |  |     |
|  |___|  |     |
|  | L    |     |
|  |      |     |
|  |      |     |
|  |  P   |     |
|  |______|     |
|               |
\_______________/