e1m1
17 17 0
A basic test map used for testing :)
/---------------\
|               |
|               |
|   | F    |    |
|   |__    |    |
|      |        |
|               |
|        ___    |
|               |
|               |
|               |
|               |
|               |
|     P         |
|               |
|               |
\_______________/