testlevel
17 17 0
A basic test map used for testing :)
ThotGeneral 5 5 5 150 10 2 100
/---------------\
|               |
|   _______     |
|   |F    |     |
|   |__   |     |
|   ___|  |     |
|   |F    |     |
|   |__   |     |
|      |  |     |
|   ___|  |     |
|  |  L   |     |
|  |      |     |
|  |      |     |
|  |  P   |     |
|  |______|     |
|               |
\_______________/